111111111111111
1S0010001000001
101010101011101
100010100010001
111010101110101
100000101000101
101111101011101
100000001000001
111111101111101
100000100000101
101110111110101
100010100000101
101010101111101
1000001000000G1
111111111111111