11111
1S001
10101
1G001
11111
